11111111111111111111111111111
1E0000000010001C00000C0100001
10100101001000001010010101011
101001001010101000100100010C1
10111C00000000011111111111101
10111111110000000000000011001
10111111111111110000000000011
1011111111111C000000000001111
10111000000000000000000000001
10111101111111111111111111101
100000000000000000000000111C1
1P0000000C00C0000000000000011
11111111111111111111111111111