1111111111
1E00000111
1C0C000001
10C1111P11
1111111111