1111111111111111111111111111111111
1E0000000000000C00000C000000000001
1010010100100000101001000000010101
1010010010101010001001000000010101
11111C000000000111111111111111C111
1111111111000000000000000000011111
1111111111111111000000000011111111
1111111111111C00000000000000000111
1111100000000000000000000000000001
1111110111111111111111111111111101
1000000000000000000000001111000001
1P0000000C00C0000000000000010000C1
1111111111111111111111111111111111