1111111111111
1C010E00000C1
1100011111001
11P0110000001
1111111111111