1111111
1110111
1P0E111
11111C1
1111111